XXXXXXXXXXXXXXXXXXXXXXXXX
XXXXXXXXXXXXdXXXXXXXXXXXX
XXXXXXXXXXXXXXXXXXXXXXXXX
XXXXXXXXXXXXXXXXXXXXXXXXX
XXXXXXXXXXXX1111111111XXX
XXXXXXXXXXX1X1XXXXXXX12XX
XXXXXXXXXX1XXX1XXXXXX11cX
XXXXXXXXX1XXXXX1XXXXXXXXX
XXXXXXXX1XXXXXXX1XXXXXXXX
XXXXXXXa1111111131XXXXXXX
XXXXXX1XXXXXXXXXXX1XXXXXX
XXXXX1XXXXXXXXXXXXX1XXXXX
XXXX1XXXXXXXXXXXXXXX1XXXX
XXX1XXXXXXXXXXXXXXXXX1XXX
XX1XXXXXXXXXXXXXXXXXXX1XX
X11111111111b11111111111X
XXXXXXXXXXXXXXXXXXXXXXXXX
