--------------------------------------------------------------------------------------------------------------------------------------------------------------------------------------------------------
--------------------------------------------------------------------------------------------------------------------------------------------------------------------------------------------------------
--------------------------------------------------------------------------------------------------------------------------------------------------------------------------------------------------------
--------------------------------------------------------------------------------------------------------------------------------------------------------------------------------------------------------
--------------------------------------------------------------------------------------------------------------------------------------------------------------------------------------------------------
------BB-------------------------------------------------------------M?--------------------------------------------BBB-----------------------------------X--------M---------?-------XXX-------M---------
-------------------------------------------------------------------------------------------------------------BBB---------------------------------------------------------------X------------------------
--------------------------M---------------BB--XXX---------BB--BBB---------------------XXX-BB--------------------BB----M-BBB-------M---------------?---------------------------XXX----------------------v
------------------------------------------------------------------------------------------------------------------XXXXXX---------------XXBB-----------------------------X-----------B-BB---------------f
------------XX-----XX-----XXX--B-----------X-X--X---BB---------------------XX-----------XXX--?------BB--------------------------------------BB----------------------XX---------------M-----------------f
--------------BB----------------BBB----BB---?----M--------------BB---XXX----------------------------------------------M--BB------BBB------------------T-?-----------------------BBB--------------------f
----------XX----------T-----------------------X--------T-------T----T------------T-X----------XX----------------T----------------E--------------------|------------------X-----------------------------f
------------------T---|-------E-----BB---T----B--------|-------|----|------------|--B--------T------------------|B-------B-----------------------------------------X-----------E--XT--------------T----f
------------------|---------X------------|-------T--XX-|-------|----|------------|-BB--------|----------B-------|T-------------------T-----X-----------------------B---------------|------BB------|----f
m-----------------|----------------------|---XX--|-----|-------|----|-----B------|----X------|----------BB------||-------------------|--EX------------------------E----------------|------------EE|-?-XX
XXXXXX-XXXXXXX-XXXXXXXXXX-XXXXXXXXXX--XXXX--XXXXXX-XXXXXXXXXXXXXXXXXXX-----XXXXXXXXXXXXXXXXXXXXXXXXXXXXXXXXXXXXXXXXXXX-XX----X---XXXXX--XXXXXX-X-XXXXXX--X-XX-XXXXXX---XX--XXXXXX-XXX-XXX-XXXXXXXXXX-XXX
